GGGGGGRRRR
RRRRRRGGGG
RGGGGGGGGG
GGGGGGGGGG
GGGGGGGGGG
RGGGGGGGGG
GRGGGGGGGR
GGRGGGGGGR
GGRGGGRRRR
GGRRRRRGGG