GGRGGGGGGG
GGRGGGGGGG
GGRGGGGGGG
GGRGGGGGGG
GGRRGGGGGG
GGGRGGGGGG
GGGRGGGGGG
GGGRRGGGGG
GGGRGRRRGG
GGGRGGGGRR