WWRWWWWWWW
WWRWWWWWWW
WWRWWWWWWW
WWRWWWWWWW
WWRRWWWWWW
WWWRWWWWWW
WWWRWWWWWW
WWWRRWWWWW
WWWRWRRRWW
WWWRWWWWRR