GGRGGGWWWW
GGGRGGWWWW
GGGRGGWWWW
GGGGGGWWWW
GGGGGWWWWW
SGGGGWWWWW
SSGGWWWWWW
WWWWWWWWWW
WWWWWWWWWW
WWWWWWWWWW